

F 90,90,90


NO ./Resources/NO.xpm           



SO ./Resources/SO.xpm




C 110,110,110



WE ./Resources/WE.xpm
EA ./Resources/EA.xpm



11      1111111111111111111111111
11      1000000001100000001030001
        1511000011100000011111111
        1001000000000000300030001
111111111011000001110000000000001   1 
100005005011000001110011111111111  101
11110111111111011100151010001       1
1111011111111101110100E010001                 1
11000000110101011111110010001                141
10000000000000001110003010001                 1
10000000000000001111110011001
1100000111010101111101111000111
11110111 1110101 151111010001   1                  1
11111111 1111111 111111111111  11                 101
                                                   1


